1234123412
1234123412
1234103412
1234003412
1231111112
1234123412